kn_root	sa_meaning	kn_root_latin	eng_meaning
ಈ	प्रदाने	ī	to give
ಓ	स्नेहे	ō	to love
ಕಾ	रक्षणे	kā	to guard
ಕೀ	रक्तपक्वे	kī	to become pus
ಕೇ	शयने निधुवने च	kē	to lie down, to have sex with
ಕುಟಕು	गाढपूरणे	kuṭaku	to cram into
ಮಿಸುಕು	स्पन्दने	misuku	to move.
ಮುಸುಕು	अवरणे	musuku	to cover.
ಕುಸುಕು	घातने	kusuku	to strike
ಕುಸುಂಕು	घातने	kusuṅku	to strike
ಪಿಸುಕು	अवज्ञातिशये	pisuku	to treat with great disrespect
ಪಿಸುಂಕು	अवज्ञातिशये	pisuṅku	to treat with great disrespect
ಕುಱುಕು	खादने	kuṟuku	to eat
ಕುಱುಂಕು	खादने	kuṟuṅku	to eat
ಮುಱುಕು	मुखविकारे	muṟuku	to distort the face
ತುಱುಕು	गाढप्रवेशे	tuṟuku	to force into
ನುಱುಕು, ನಱುಕು	वृद्धिहीने	nuṟuku, naṟuku	to be or become deficient in growth
ಇಱುಕು	निग्रहग्रहणे	iṟuku	to hold firmly, etc.
ಇಱುಂಕು	निग्रहग्रहणे	iṟuṅku	to hold firmly, etc.
ಸಾಕು	रक्षणे	sāku	to preserve, foster
ಜರ್ಕು	नखघातने	jarku	to strike with the nails or claws
ನೂಂಕು	प्रेरणे	nūṅku	to push on
ಸೊಂಕು	स्पर्शने	soṅku	to touch
ಕೂಂಕು	उत्सर्पने	kūṅku	to crawl up
ತೆಂಕು	प्लवने	teṅku	to float, swim
ಅವುಂಕು	दृढपीडने	avuṅku	to press firmly
ಕಲಂಕು	आळोडने	kalaṅku	to stir up
ಚಲುಕು	जलोत्सर्जने	caluku	to urinate
ಚಲುಂಕು	जलोत्सर्जने	caluṅku	to urinate
ಚಲಕು	करविमाचने	calaku	to loosen from out of the hand
ಚಲಂಕು	करविमाचने	calaṅku	to loosen from out of the hand
ಪೊಳಕು	चर्वनक्रियायाम्	poḷaku	to chew
ಪೊಳಂಕು	चर्वनक्रियायाम्	poḷaṅku	to chew
ಪಳಂಕು	गाढस्पर्शने	paḷaṅku	to touch strongly or forcibly to push
ಪಲುಂಕು, ಪೞುಕು	प्रेरणे	paluṅku, paḻuku	to push
ಹಲಕು	वृक्षरोहणे	halaku	to climb, as a tree
ಉಲುಕು	शरीरस्फुरने	uluku	the body to shake
ಮುಲುಕು	प्रसवनक्रियायाम्	muluku	to be in labour
ಕುಲುಕು	गाढपूरने	kuluku	to cram into
ತೊಡಕು	विपर्यसे	toḍaku	to oppose
ತೊಡಂಕು	विपर्यसे	toḍaṅku	to oppose
ಕೊಂಕು	कौटिल्ये	koṅku	to get crooked, to bend
ಬಂಕು	कौटिल्ये	baṅku	to get crooked, to bend
ತುಡುಕು	सत्वरग्रहणे	tuḍuku	to seize or grasp hastily
ತುಡುಂಕು	सत्वरग्रहणे	tuḍuṅku	to seize or grasp hastily
ಪುಡುಕು	करान्वेषणे	puḍuku	to search for with the hands
ಪುಡುಂಕು	करान्वेषणे	puḍuṅku	to search for with the hands
ಮಿಡುಕು	चैतन्ये	miḍuku	to recover consciousness
ಮಿಡುಂಕು	चैतन्ये	miḍuṅku	to recover consciousness
ಇಡುಕು	गाढविमॊचने	iḍuku	to unloose vehemently
ಇಡುಂಕು	गाढविमॊचने	iḍuṅku	to unloose vehemently
ಅಡಕು	स्थानान्तरप्रणीते	aḍaku	to put in another place
ಕುಡುಕು, ಅಡುಕು	चञ्चुघातने	kuḍuku, aḍuku	to peck
ಕರ್ದುಕು	लघुचञ्चुघतने	karduku	to peck lightly
ಕರ್ದುಂಕು	लघुचञ्चुघतने	karduṅku	to peck lightly
ಬರ್ದುಕು	जीवनार्थे	barduku	to live
ಬರ್ದುಂಕು	जीवनार्थे	barduṅku	to live
ಬೆದಕು	अन्वेषणे	bedaku	to search for
ಕುಡುಕು	ईषत्प्रधवने	kuḍuku	to wash gently
ಮುಡುಕು, ಮುದುಕು, ಮುದುಹು	शरीरॊपगुहने	muḍuku, muduku, muduhu	to embrace the body
ಮಿನುಕು	अन्तर्गतस्वने	minuku	to speak in an indistinct tone
ಹೆಣಕು	कदर्थने	heṇaku	to irritate or provoke
ಕುಣುಕು	मुसलक्रियायाम्	kuṇuku	to pound
ಕೊಣಕು	मृगलङ्घने	koṇaku	to leap, as a wild beast
ತಿಣುಕು	अपानवायौ	tiṇuku	to fart
ಬಿಕ್ಕು	उच्छ्वासे	bikku	to sigh, sob
ಒಕ್ಕು	खलकरने	okku	to work on the floor for treading out corn
ಇಕ್ಕು	त्यागहननयोः	ikku	to deposit; to kill
ನಕ್ಕು	लेहने	nakku	to lick
ಪಿಕ್ಕು	विवरणे	pikku	to separate
ಎಕ್ಕು	विभजने	ekku	to divide
ತೆಕ್ಕು	तिर्यक्कण्डूतिलाहने	tekku	to lick the itch as beasts do
ಕೆಕ್ಕು	गोशिक्षध्वनौ	kekku	to shout in training cattle
ಮುಕ್ಕು	खादनविशेषे	mukku	to eat in a certain manner.
ನೆಕ್ಕು	अन्तर्लीने	nekku	to disappear
ಕುಕ್ಕು	वस्त्रस्वल्पघातने	kukku	to beat a cloth to a small extent
ಮುೞುಕು	जलनिमज्जने	muḻuku	to be immersed in water
ಮುೞುಂಕು	जलनिमज्जने	muḻuṅku	to be immersed in water
ತುಳುಕು	सेचने	tuḷuku	to sprinkle
ತುಳುಂಕು	सेचने	tuḷuṅku	to sprinkle
ಬಳ್ಕು	नमने	baḷku	to bend
ನಿಳ್ಕು	उपरिस्पर्शने	niḷku	to touch above
ಉಳ್ಕು	दीप्तौ	uḷku	to shine
ಅಳ್ಕು	भये	aḷku	to fear
ತಳ್ಕು	अनुलेपने	taḷku	to anoint the body.
ಒೞ್ಕು	प्रवाहे	oḻku	to flow
ಅೞ್ಕು	जीर्णे	aḻku	to be worn out
ಉರ್ಕು	औद्धत्ये	urku	to be proud
ಸೊರ್ಕು	उन्मादे	sorku	to grow proud
ಸಿರ್ಕು	प्रतिबन्धे	sirku	to be impeded, entangled.
ಸಿಲ್ಕು	प्रतिबन्धे	silku	to be impeded, entangled.
ಸುರ್ಕು	सङ्कॊचे	surku	to contract, shrivel.
ಚೆರ್ಕು	नखक्षते	cerku	to wound with the nails or claws.
ಸೆಱ್ಕು, ಸೆರ್ಕು	वस्त्रान्तरप्रवेशे	seṟku, serku	to tuck into
ಮೊರಕು, ಮೊರ್ಕು	दर्पघूर्णने	moraku, morku	to be in trembling oscillation from haughtiness.
ಕೋ	सूत्रप्रवेशे	kō	to enter, as a thread into a needle, to be threaded, to thread
ಉಗಿ	आकर्षणे	ugi	to draw towards
ಮುಗಿ	पुष्पसङ्कोचने	mugi	to contract, as a flower
ಬಗಿ	विश्लेषे	bagi	to divide, separate
ಸುಗಿ	भये	sugi	to fear
ಬಿಗಿ	बन्धने	bigi	to fasten
ಅಗಿ	सन्त्रास-हर्ष-चर्वनेषु	agi	to tremble or fear; to be glad; to chew
ಚಿಗಿ	अङ्गुलिविसर्जने	cigi	to let loose from the fingers, to discharge or propel with the fingers
ಪುಗು	प्रवेशे	pugu	to enter
ನಗು	हसने	nagu	to laugh
ಉಗು	विसर्जने	ugu	to let loose, throw away
ಮಿಗು	अतिक्रमने	migu	to exceed, etc.
ಮುಗ್ಗು	जीर्णावगन्धे	muggu	to get or have a corrupt, musty smell
ಉಗ್ಗು	वचनविरॊधे	uggu	to stammer
ಪ್õಗು	गमने	põgu	to go
ಆಗು	प्रादुर्भवे	āgu	to become manifest, to become
ಕೂಗು	उच्चैर्ध्वनौ	kūgu	to cry aloud, shout
ತೇಗು	उदानवायौ	tēgu	to belch
ತಾಗು	सङ्घट्टने	tāgu	to come into close contact
ಬಾಗು	नम्रत्वे	bāgu	to bend or bow
ತೂಗು	तुलने	tūgu	to weigh
ಬೀಗು	हर्षभवे	bīgu	to be glad
ಕೇಗು	मयूरस्वने	kēgu	to cry, as a peacock
ನೀಗು	त्यजने	nīgu	to leave or quit
ಹುದುಗು	ग्õपने	hudugu	to guard, conceal
ಸಿದುಗು	हस्तन्वेषणे	sidugu	to search about or for with the hands
ಪೊನ್ಗು	स्फुटने	pongu	to burst, open, expand
ನುಂಗು	गिलने	nuṅgu	to swallow
ಕುನುಂಗು	सङ्कॊचने	kunuṅgu	to contract
ತಾಂಗು	धारण-सङ्घट्टनयोः	tāṅgu	to support; to come into close contact
ಜಿನುಗು	अव्यक्तध्वनौ	jinugu	to sound inarticulately, to mutter
ಜಿನುಂಗು	अव्यक्तध्वनौ	jinuṅgu	to sound inarticulately, to mutter
ಮಲಗು	उपधानावलम्बे	malagu	to lie down, recline
ಮಲಂಗು	उपधानावलम्बे	malaṅgu	to lie down, recline
ಚೆಲಂಗು	करमुक्तौ	celaṅgu	to let go from the hand
ತೊಲಗು	विविक्ते	tolagu	to move away, separate from
ಪಿಂಗು	अपसरने	piṅgu	to go away, to retreat
ಮಿಸುಗು	कान्तौ	misugu	to shine
ಎಸಗು	उद्योगे	esagu	to undertake, to commence
ಮಸಗು	विजृम्भणे	masagu	to open, extend, appear
ಕರಗು	विलीने	karagu	to be dissolved, melt
ಕೊರಗು, ರಹವಿಹೀನೇ	रसविहिने	koragu, rahavihīnē	to be deprived of juice, to shrivel
ಹರಗು	सस्यक्रियायाम्	haragu	to work in a corn-field
ಮಱುಗು	सन्तापे	maṟugu	to burn, grieve
ಎಱಗು	प्रणते	eṟagu	to stoop, to bow
ಮಿಱುಗು	चकचकयामने	miṟugu	to glitter
ತುಱುಗು	सञ्छन्ने	tuṟugu	to be covered or enveloped
ಉಱುಗು	वक्रभवे	uṟugu	to be crooked, bent,
ಒರಗು, ಒಱಗು	सुप्तौ	oragu, oṟagu	to lie down, sleep
ಕರಂಗು, ಕಱಂಗು	कार्ष्ण्ये	karaṅgu, kaṟaṅgu	to turn black
ಉಡುಗು	सङ्कोचने	uḍugu	to contract
ತೊಡಗು	प्रारम्भे	toḍagu	to begin
ಮಡಗು	ग्õपने	maḍagu	to hide, conceal
ನಡುಗು	कम्पने	naḍugu	to tremble
ಮಿಡುಗು	सङ्खिन्ने	miḍugu	to grieve
ಕಡಂಗು	औत्सुक्ये	kaḍaṅgu	to desire
ಅಡಂಗು	गॊपने	aḍaṅgu	to hide
ಒಣಗು	श्õषणे	oṇagu	to become dry
ಎಡೆಯುಡುಗು	विच्छेदे	eḍeyuḍugu	to sever
ತೊಳಗು	कान्तौ	toḷagu	to shine
ಬೆಳಗು	कान्तौ	beḷagu	to shine
ಮುೞುಗು	निमग्ने	muḻugu	to submerge
ಅಲುಗು	सञ्चलने	alugu	to shake
ಅೞಿ	क्षीणत्वे	aḻi	to decay, to grow less
ಅೞ್ಗು	क्षीणत्वे	aḻgu	to decay, to grow less
ತೞ್ಗು	क्षीणत्वे	taḻgu	to decay, to grow less
ಮುೞ್ಗು	पतने	muḻgu	to fall down
ಮೊೞ್ಗು	नमने	moḻgu	to bow.
ಅೞ್ಗು	लये	aḻgu	to dissolve
ಪುೞ್ಗು	दहनक्रियायाम्	puḻgu	to burn
ಉೞ್ಗು	स्नेहे	uḻgu	to love
ಮೊೞಗು	वदनक्रियायाम्	moḻagu	to sound, as musical instruments
ಒೞ್ಗು	सम्मेळने	oḻgu	to unite
ನುೞ್ಗು, ನುಳ್ಗು, ನುೞ್ಗು	सञ्चूर्णे	nuḻgu, nuḷgu, nuḻgu	to be grounded
ಕುೞ್ಗು	आकुञ्चने	kuḻgu	to bend together, contract
ಕೞ್ಗು	कार्ष्ण्ये	kaḻgu	to turn black
ನೆೞ್ಗು, ನೆರ್ಗು	अन्तर्लीने	neḻgu, nergu	to sink in, be depressed
ಒಗೆ	जनन-वस्त्रप्रक्षालनयोः	oge	to be born, to wash clothes
ಬಗೆ	परिभावे	bage	to reflect
ಹೊಗೆ	धूपधूमनिरोधक्रियायाम्	hoge	to fume in the smoke of incense and other materials, to smoke
ನೆಗೆ	उत्पवने	nege	to be purified, become clear
ಮೊಗೆ	जलाकर्षणे	moge	to bring water
ಪಿಡುಗು	संछिन्ने	piḍugu	to cut to pieces
ತಗೆ	स्तम्भने	tage	to become stiff
ಮಿಂಚು	दीप्तौ	miñcu	to shine
ಮುಂಚು	अग्रगमने	muñcu	to go before
ಪಿಂಚು	पश्चादर्थे	piñcu	to be behind
ಹೊಂಚು	सङ्केतोद्योगे	hoñcu	to exert one’s self secretly
ಪಳಂಚು	सङ्घट्टने	paḷañcu	to come into close contact
ಜಱುಚು	बहुभाषायाम्	jaṟucu	to chatter
ಅಱುಚು	उच्चैर्ध्वनौ	aṟucu	to cry aloud
ಮೋಚು	वैधव्ये	mōcu	to become a widow
ಕವಿಚು	विपरीतपतने	kavicu	to be turned upside down
ಪೆರ್ಚು	विस्तारे	percu	to increase
ಮರ್ಚು	अतिपरिचये	marcu	to be intimately acquainted with
ಬೆರ್ಚು	सन्त्रासे	bercu	to fear
ಕರ್ಚು	खादने	karcu	to bite
ಬಾರ್ಚು	पुञ्जीकरणे	bārcu	to heap
ತೀರ್ಚು	निष्पत्तौ	tīrcu	to finish
ಉರ್ಚು	आकर्षणे	urcu	to draw towards one's self
ಬಿರ್ಚು	विभजने	bircu	to divide, to loosen
ಪರ್ಚು, ಅರ್ಚು	अव्यक्तध्वनौ	parcu, arcu	 to whisper
ಪೆಟ್ಟುವೆರ್ಚು, ಬೆಟ್ಟುವೆರ್ಚು	दर्पे	peṭṭuvercu, beṭṭuvercu	to be haughty
ಚುರ್ಚು	दहे	curcu	to burn
ಚುರ್ಚು	शिखिसन्धारने, शिशुसन्धारणे	curcu	to burn, to raise young
ಮುಚ್ಚು	आच्छदने	muccu	to cover
ಮೆಚ್ಚು	अभ्युपगमे	meccu	to assent
ನಚ್ಚು	विश्वासे	naccu	to trust
ಎಚ್ಚು	अञ्जनक्रियायाम्	eccu	to smear
ಕೆಚ್ಚು	तन्तुवायक्रियायाम्	keccu	to do (a certain kind of) weaving-business
ನಾಣ್ಚು	लज्जायाम्	nāṇcu	to be ashamed
ಕಡೆಗಣ್ಚು	अवज्ञायाम्	kaḍegaṇcu	to slight, contempt
ನುಣ್ಚು	अपसरणे	nuṇcu	to move off
ಅಲರ್ಚು	विकसने	alarcu	to cause to expand or open
ಎಲರ್ಚು	चेतनकरणे	elarcu	to give strength or animation
ಉದಿರ್ಚು	अधःपतने	udircu	to cause to fall down (from above)
ಸಾರ್ಚು	समीपागमने	sārcu	to make go or come near or to
ಸ್õರ್ಚು	गलने	sõrcu	to cause to drop
ಒಡರ್ಚು	उद्यमे	oḍarcu	to make effort; to begin
ತೊಡರ್ಚು	बन्धने	toḍarcu	to bind
ಬಿದಿರ್ಚು	रथविमोचने	bidircu	to unharness or unyoke as a coach
ಅಮರ್ಚು	सङ्घटिकरणे	amarcu	to put into close contact, to join
ಬೆಮರ್ಚು	स्वेदकरणे	bemarcu	to cause perspiration
ನಿಮಿರ್ಚು	प्रसारणे	nimircu	to cause to be stretched
ಪೊಣರ್ಚು	सम्युगे	poṇarcu	to join, to unite
ತಳರ್ಚು	स्थानापगमने	taḷarcu	to cause to go away from a place
ಸಡಿಲ್ಚು	सैथिल्ये	saḍilcu	to loosen
ಕೊರಲ್ಚು	आक्रोशध्वनौ	koralcu	to vociferate
ಪುಯಲ್ಚು	आक्रोशध्वनौ	puyalcu	to vociferate
ಮರಲ್ಚು (ಚ್ಫ಼್. 622)	पराङ्मुखीकरने	maralcu (cf. 622)	to avert the face
ಮಗುೞ್ಚು	पराङ्मुखीकरने	maguḻcu	to avert the face
ನುಗುಳ್ಚು	सूक्ष्मद्वारप्रवेशे	nuguḷcu	to cause to enter a small opening
ಮುಗುಳ್ಚು	सङ्कोचकरणे	muguḷcu	to cause to contract
ಸುರುಳ್ಚು	सङ्कोचने	suruḷcu	to contract
ತೆರಳ್ಚು	चलने	teraḷcu	to cause to move
ಪೊರಳ್ಚು	लुठने	poraḷcu	to cause to welter
ಕೆರಳ್ಚು	आस्फोटने	keraḷcu	to make great noise by slapping or clapping the arms (one ms. kōpōdrēkē to enrage)
ಕುರುಳ್ಚು	शस्त्रसञ्चालने	kuruḷcu	to shake a weapon
ಉರುಳ್ಚು	निम्नागमनकरणे	uruḷcu	to cause to roll down
ಹರೞ್ಚು	नेत्रविरोधकरणे	haraḻcu	to impede or trouble the eye
ಎೞಲ್ಚು	आलम्बने	eḻalcu	to cause to hang down
ಕೞಲ್ಚು	पृथक्करणे	kaḻalcu	to separate
ಬೞಲ್ಚು	निश्चेष्टयाम्	baḻalcu	to deprive of motion, activity
ಬೞಿಲ್ಚು	अधःस्रंसने	baḻilcu	to cause to fall down
ಅಗುೞ್ಚು	जलाशयमग्ने	aguḻcu	to sink in the ocean
ಅೞಲ್ಚು	दुःखोत्पादने	aḻalcu	to make sorrowful
ಕಿಮುೞ್ಚು	हस्तमर्दने	kimuḻcu	to crush with the hand
ನೆಗೞ್ಚು	विख्यातौ	negaḻcu	to make famous
ತಗುಳ್ಚು, ತಗುೞ್ಚು	उद्योगे	taguḷcu, taguḻcu	to engage in
ಅಂಜು	भये	añju	to fear
ಪಿಂಜು	पृथक्करणे	piñju	to separate
ನಂಜು	ईषल्लेहने	nañju	to lick a little
ಬೆರಂಜು	चयने	berañju	to collect together
ಮಾಂಜು	अपलापे	māñju	to evade, speak evasively
ದಾಂಟು	लङ्घने	dāṇṭu	to jump over, cross.
ದೂಂಟು	एकपादगतौ	dūṇṭu	to walk on one leg.
ಕೂಂಟು	विकृतगतौ	kūṇṭu	to walk in a disfigured manner, to halt
ಮೀಂಟು	उत्पाटने	mīṇṭu	to pull out
ಇಂಟು, ಈಂಟು	पाने	iṇṭu, īṇṭu	to drink
ನಾಂಟು	अन्तर्भेडे	nāṇṭu	to be pierced into
ತೆಂಟು	कूर्पकरणे	teṇṭu	to winnow
ಸೀಂಟು	गुदसम्मार्जने	sīṇṭu	to wipe the anus
ಬೆರಂಟು	अङ्गुलिक्रियायाम्	beraṇṭu	to make a certain performance with the fingers
ಮುರುಂಟು	दहनकरणे	muruṇṭu	to cause to burn
ಸುರುಂಟು	सङ्कोचने	suruṇṭu	to contract
ಕೆರಂಟು	नखखनने	keraṇṭu	to dig with the nails or claws
ಬೆರಂಟು	नखखनने	beraṇṭu	to dig with the nails or claws
ತೆರಂಟು	निवसनोद्वहने	teraṇṭu	to make a gift of raiment at a wedding
ಉರುಟು	अतिक्रमणे	uruṭu	to be overbearing
ತಾಟು	सङ्घट्टने	tāṭu	to come inte close contact
ಬಗಟು	ऊरुविश्लेषे	bagaṭu	to disunite the legs
ಪುಟ್ಟು	उत्पत्तौ	puṭṭu	to be born
ಕಟ್ಟು	बन्धने	kaṭṭu	to bind, to build
ಕುಟ್ಟು	टाडने	kuṭṭu	to strike, to pound
ಬೆಟ್ಟು	गाढप्रवेशे	beṭṭu	to cause to enter firmly
ಮುಟ್ಟು	स्पर्शने	muṭṭu	to touch
ಕಿಟ್ಟು	स्पर्शने	kiṭṭu	to touch
ಅಟ್ಟು	अनुधावने	aṭṭu	to run after
ಅಱೆಯಟ್ಟು	अनुधावने	aṟeyaṭṭu	to run after
ಎೞ್ಬಟ್ಟು	अनुधावने	eḻbaṭṭu	to run after
ಮೆಟ್ಟು	पदविन्यासे	meṭṭu	to place the foot, step
ತಿಟ್ಟು	भर्त्सने	tiṭṭu	to abuse
ಸುಟ್ಟು	अङ्गुलिदर्शने	suṭṭu	to point at with the finger
ಕಿಡುಕುಟ್ಟು, ಕಿಡಿಗುತ್ತು	सङ्घट्टने	kiḍukuṭṭu, kiḍiguttu	to come into close contact
ಸಮಕಟ್ಟು	विधाने	samakaṭṭu	to arrange
ಗುಡಿಕಟ್ಟು	वर्णपूररेखायाम्	guḍikaṭṭu	a ring or halo to form
ತಟ್ಟು	ताडने	taṭṭu	to strike
ಎಟ್ಟು	ऊर्ध्वगतवस्तुग्रहणे	eṭṭu	to reach a thing placed on high
ಒಟ್ಟು	एकक्रियायाम्	oṭṭu	to make one, to put together
ಜಡಿ	तर्जने	jaḍi	to menace
ಬಡಿ	ताडने	baḍi	to strike
ನುಡಿ	वचने	nuḍi	to speak
ಪಿಡಿ	ग्रहणे	piḍi	to seize
ಸಿಡಿ	विकीर्णे	siḍi	to scatter
ಕುಡಿ	पाने	kuḍi	to drink
ಮಿಡಿ	अङ्गुलिप्रहरणे	miḍi	to strike with the finger
ಮುಡಿ	कॆशबन्धने	muḍi	to tie (or set in) the hair
ಉಡಿ	म्õटने	uḍi	to break
ಕಡಿ	खण्डने	kaḍi	to cut
ಮಡಿ	मरणे	maḍi	to die
ಗಿಡಿ	कबळप्रवेशे	giḍi	to enter in, or make enter, by mouthfuls
ಇಡಿ	चूर्णे	iḍi	to be powdered
ಅಡು	पचने	aḍu	to cook.
ಸುಡು	दाहे	suḍu	to burn
ತುಡು	शरसन्धाने	tuḍu	to fix the arrow (to the bow)
ಕುಡು	प्रदाने	kuḍu	to give
ಬಿಡು	विमोचने	biḍu	to let go
ಉಡು	वस्त्रप्रवेष्टने	uḍu	to enter into clothes
ನಡು	सम्स्थापने	naḍu	to plant
ಪಡು	मरणे	paḍu	to die
ಸೆಡು	स्यूतौ	seḍu	to be sewed, stitched, united, to sew
ಇಡು	करविमोचने	iḍu	to let go or send off from the hand
ಕಿಡು	विनाशे	kiḍu	to be ruined.
ಮಡು	दृढसन्धाने	maḍu	to put firmly or close together
ಆಡು	नर्तने	āḍu	to dance, to play
ಪಾಡು	गाने	pāḍu	to sing
ನೋಡು	प्रेक्षणे	nōḍu	to see
ಕಾಡು	अवहेलने	kāḍu	to treat disrespectfully
ತ್õಡು	निष्क्रमणे	tõḍu	to go out, come forth
ನೀಡು	प्रसारणे	nīḍu	to stretch out.
ಓಡು	पलायने	ōḍu	to flee
ಮಾಡು	करने	māḍu	to make, to do
ತೀಡು	वायुस्पर्शने	tīḍu	to touch, as sin or wind
ಸೂಡು	पुष्पधारणे	sūḍu	to dress with flowers
ಕೂಡು	सम्मेलने	kūḍu	to come together
ಊಡು	भॊजनक्रियायाम्	ūḍu	to take food
ಮೂಡು	उत्पत्तौ	mūḍu	to be born, to rise
ಕೊಡು	शैत्ये	koḍu	to be cold
ಬೇಡು	यच्ञयाम्	bēḍu	to beg
ಬಾಡು	म्लाने	bāḍu	to fade
ಹೂಡು	योजने	hūḍu	to join, to harness.
ಅೞ್ಕಾಡು	निरवशेषे	aḻkāḍu	to be consumed or finished.
ತಡಮಾಡು, ತಡಮ್ಮಾಡು	विपर्यासे	taḍamāḍu, taḍammāḍu	to delude, perplex, etc.
ಓಲಾಡು	जलखेलने	ōlāḍu	to move to and fro in water, etc.
ಏಸಾಡು	शरगतौ	ēsāḍu	to shoot as an arrow.
ಈಸಾಡು	जलोत्तरणे	īsāḍu	to cross water, to swim.
ಬೀಸಾಡು	करविमोचने	bīsāḍu	to let go from the hand, to throw away.
ಹರಡು	अङ्गुलिखनने	haraḍu	to dig with the fingers, etc.,
ಕದಡು	कलुषे	kadaḍu	to become turbid.
ಕಲಡು	कलुषे	kalaḍu	to become turbid.
ಮುದುಡು	सङ्कोचणे	muduḍu	to contract, shrink, etc.
ಹೊರಡು	परिलुठने	horaḍu	to roll about, to welter, etc.
ಔಡು	दन्तचर्वणे	auḍu	to chew with the teeth.
ಹರಡು	प्रसारणे	haraḍu	to spread.
ಅಲ್ಲಾಡು	सञ्चलने	allāḍu	to shake.
ಕೊಂಡಾಡು	अत्यादरे	koṇḍāḍu	to show excessive regard, to praise.
ಆಸೆವಡು	ईप्सायाम्	āsevaḍu	to desire.
ಪಡಲಿಡು	विकीर्णपतने	paḍaliḍu	to fall scattered.
ಮುಂಬಿಡು	पुरोवगमने	mumbiḍu	to go or place before.
ಹೊಲಬುಗಿಡು	दिग्भ्रमणे	holabugiḍu	to become bewildered.
ಒಡಂಬಡು	अभ्युपगमे	oḍambaḍu	to agree.
ಮೂಗುವಡು	मौने	mūguvaḍu	to become silent.
ಬಿಸಾಡು	प्रमादत्यजने	bisāḍu	to throw away madly, etc.
ಬಿಸುಡು	प्रमादत्यजने	bisuḍu	to throw away madly, etc.
ಹೋಗಾಡು	प्रमादत्यजने	hōgāḍu	to throw away madly, etc.
ಈದಾಡು	प्रमादत्यजने	īdāḍu	to throw away madly, etc.
*ಅಳ್ಕಜಂಬಡು	असूय्ये	*aḷkajambaḍu	to envy.
ಕರುವಿದು	लेप्यकर्मणे	karuvidu	to mould, etc.
ತಿಟ್ಟವಿಡು	चित्रप्रारम्भे	tiṭṭaviḍu	to delineate, etc.
ಉಬ್ಬಸಂಬಡು	उत्साहनिग्रहे	ubbasambaḍu	(o.r. ucchvāsanigrahē) to become asthmatic.
ದಾೞಿಡು	दूरधावने	dāḻiḍu	to rush far, etc.
ಗೋೞಿಡು	आक्रोशध्वनौ	gōḻiḍu	to roar, to howl.
ಊಳಿಡು	जम्बुकस्वनौ	ūḷiḍu	to howl as a jackal.
ಮೆಯ್ವಿಡು	निःशङ्कतायाम्	meyviḍu	to be without hesitation, be fearless.
ಕೂಗಿಡು	उच्चैर्ध्वनौ	kūgiḍu	to cry aloud.
ಬಾಯ್ವಿಡು	दैन्ये	bāyviḍu	to grow low-spirited, etc.
ಬೆಕ್ಕಸಂಬಡು	विस्मये	bekkasambaḍu	to be surprised.
ಪೊಡಮಡು	नमस्कारे	poḍamaḍu	to make obeisance.
ತಲೆಮಡು, ತಲೆವಡು	शिरस्सन्धाने	talemaḍu, talevaḍu	to join heads.
ರೂಪಿಡು	क्र्õधनिर्देशे	rūpiḍu	to indicate anger or passion.
ಕಾಪಿಡು	संरक्षणे	kāpiḍu	to protect.
ಬೇರ್ಪದು	विविक्ते	bērpadu	be separated.
ನೇರ್ಪದು	सम्श्लेșए	nērpadu	to be united etc.
ಒಡ್ಡು	प्रतिकारे	oḍḍu	to counteract, oppose .
ಹಿಂಡು	मुष्टिनिष्पीडने	hiṇḍu	to squeeze out with the fist (o.r.. niṣpīḍanē)
ಚಿವುಡು	नखच्छेदे	civuḍu	to cut off with the nails.
ಕೈಮಾಡು	शस्त्रसञ्चालने	kaimāḍu	to brandish a weapon.
ಬಾಯ್ಮದು	प्रतिज्ञायाम्	bāymadu	to assert, etc.
ಕೊಱಚಾಡು	मर्मोद्घाटनवचने	koṟacāḍu	to speak so as to reveal a secret, etc.
ಱ್õಡಾಡು	वक्रिताङ्गापहसने	ṟõḍāḍu	to deride with grimaces, etc.
ಒಡೆ	स्फ्õटने	oḍe	to break.
ಪೊಡೆ	प्रहरणे	poḍe	to strike:
ಸೆಡೆ, ಸಿಡೆ	आस्थौल्ये	seḍe, siḍe	to increase .
ಕೆಡೆ, ಕಿಡೆ	पतने	keḍe, kiḍe	to fall.
ಅಡೆ	अङ्गुलिप्रहरणे	aḍe	to strike or throw with the finger.
ಪಡೆ	उपार्जने	paḍe	to acquire.
ಕಡೆ	मथने	kaḍe	to churn.
ತಡೆ	कालक्षेपे	taḍe	to delay.
ತೊಡೆ	सम्मार्जने	toḍe	to wipe, etc..
ನಡೆ	गमने	naḍe	to walk.
ಕಟ್ಟುವಡೆ	मनोनिर्õधॆ	kaṭṭuvaḍe	the mind to be fettered, etc.
ಮೊಗಂಬಡೆ	अनुनये	mogambaḍe	to be polite etc.
ಜೇವಡೆ	सिञ्जिनिप्रहरणे	jēvaḍe	to twang a bow. string (o.r. jēvoḍe).
ಮಣಿ	नमने	maṇi	to bow;
ಕುಣಿ	नर्तने	kuṇi	to dance.
ತಿಣಿ	सङ्कार्णे	tiṇi	to be mixed together, etc.
ತಣಿ	तृप्तौ	taṇi	to be satisfied.
ಅಣೆ	स्पर्शने	aṇe	to come in contact with (o.r. aṇi).
ಉಣ್	भाजने	uṇ	to take a meal.
ಕಾಣ್	दर्शने	kāṇ	to see.
ಮಾಣ್	निवारणे	māṇ	to cease, etc.
ಪೂಣ್	प्रतिज्ञायाम्	pūṇ	to promise, to assent, etc.
ಪಣ್ (ಪಣ್ಣು)	सज्जिकरणे	paṇ (paṇṇu)	to make ready.
ಅಣೆ	अङ्गुलिप्रहरणे	aṇe	to strike or propel with the finger.
ಸೊಣೆ	अङ्गुलिप्रहरणे	soṇe	to strike with the fingers, etc.
ಪೆಣೆ	मिश्रबन्धने	peṇe	to unite miscellaneous things, twist, etc..
ಸೆಣೆ	क्र्õधे	seṇe	to be angry.
ನೊಣೆ	गिलने	noṇe	to swallow.
ತೊಣೆ	शटार्ते	toṇe	to cheat.
ಒತ್ತು	आक्रमणे	ottu	to press, etc.
ಸುತ್ತು	वेष्टनॆ	suttu	to surround.
ಮುತ್ತು	निड़ॊधावरणे	muttu	to cover so as to obstruct, hem in.
ಕೆತ್ತು	स्पन्दने	kettu	to quiver.
ಕುತ್ತು	घतने	kuttu	to strike, beat.
ಕೆತ್ತು	तनूकरणे	kettu	to make thin, chip.
ತುತ್ತು	कबलने	tuttu	to take by mouthful.
ಪತ್ತು	सम्श्लेșए	pattu	to be in contact; kalaha-saṅkhyayõḥ a fight; the number 10.
ಬತ್ತು	निर्द्रवे	battu	to lose wetness, dry up.
ಬಿತ್ತು	बिजस्थापने	bittu	to put seeds, sow:
ಪೊತ್ತು	अग्निपटूकरणे	pottu	to be kindled, etc.,
ತೇ	अपसरणे	tē	to move off, go away, etc.
ತಾ	अर्द्रवकरणे	tā	to make wet; to be wet.
ಹದಿ	खननविवरणे	hadi	to uncover by digging, etc.
ಪುದಿ	अच्छदने	pudi	to be covered.
ಗುದಿ	पदबन्धने	gudi	to tie the feet.
ಮಿದಿ	मुसलक्रियायाम्	midi	to work with the pestle, to pound; ghāta-mardanayōḥ to kill, to grind.
ಕುದಿ	सन्तापे	kudi	to boil, etc.
ಕದು	युद्धे	kadu	to fight.
ಮೊದು	ताडने	modu	to strike.
õದು	पठने	õdu	to read.
ಊದು	श्वासप्रहरणे	ūdu	to strike with the breath
ಉರ್ದು	सन्निघृष्टे	urdu	to rub,
ಗುರ್ದು	मुष्टिताडने	gurdu	to strike with the fist.
ತಿರ್ದು	ऋजूकरणे	tirdu	to make straight or right.
ಬರ್ದು	मरणे	bardu	to die.
ಪೊರ್ದು	समीपे	pordu	to be near.
ಅೞ್ದು	जलमग्ने	aḻdu	to sink under water, dive (o.r. āḻdu).
ತಾಳ್ದು	धरणे	tāḷdu	to hold, etc.
ಮೊಳ್ದು	अतिक्रमणे	moḷdu	to transpass, transgress.
ತೆಮಳ್ದು	चयने	temaḷdu	to amass.
ಸೇಂದು	जलनिष्क्रमणे	sēndu	to draw up water.
ನಾಂದು	द्रवीकरणे	nāndu	to liquefy.
ಹೊಂದು	मरणे	hondu	to die.
ಸುಂದು	मैथुने	sundu	to lie with.
ನಂದು	विनाशे	nandu	to perish.
ಮಾಂದು	प्रतिषेधे	māndu	to stop (o.r. prasiddhē).
ಒಂದು	सम्मेलने	ondu	to be united.
ಕಂದು	गतकान्तौ	kandu	to lose one's lustre:
ಕುಂದು	क्षये	kundu	to decrease .
ಮುಂದು	पुरस्सरणे	mundu	to go before .
ಒದೆ	पादप्रहरने	ode	to strike with the foot.
ಹೊದೆ	आच्छादने	hode	to cover.
ತದೆ	ताडने	tade	to strike.
ಸದೆ	इषच्चूर्णे	sade	to crush a little or slightly, to squash.
ಪದೆ	ईप्सायाम्	pade	to desire.
ಮುದು	वृद्धौ	mudu	to grow old, etc.
ಮೊದೆ	मुञ्जतृणे	mode	the grass Saccharum munja (not in all Mss.).
ಮುನಿ	क्र्õधे	muni	to be angry,
ಕುನಿ	आकुञ्चने	kuni	to bend (v.i.); vakrabhūmau crooked or bent ground.
ಹನಿ	बिन्दुपतने	hani	to fall in drops.
ನಾನ್	आर्द्रभावे	nān	to become wet.
ಬನ್	कुलालकरणे	ban	to do the work of a potter; ākāśagōmayapiṇḍapuñjayõḥ the sky; a heap of cakes of cow-dung.
ಆನ್	धारणे	ān	to hold.
ನೋನ್	व्रताचरणे	nōn	to perform a vow.
ಸೀನ್	क्षुतकरणे	sīn	to sneeze.
ಕ್üನ್	आनमे	kün	to bend.
ಪೇನ್, ಹೇನ್	यूकसमृद्धौ	pēn, hēn	lice to increase.
ಈನ್	तिर्यक्प्रसवे	īn	to bring forth, as cattle and other beasts.
ತಿನ್	खदने	tin	to eat.
ಎನ್	भाषणे	en	to say.
ನೆನೆ	स्मरणे	nene	to remember.
ನನೆ	आर्द्रभावे	nane	to became wet.
ತೊನೆ	आन्दोलने	tone	to swing backwards and forwards.
ಕೊನೆ	स्वीकृतार्थवर्धने	kone	to succeed in one's adopted cause.
ಒನೆ	शूर्पकरणे	one	to winnow.
ನೋ	व्यथने	nō	to suffer pain.
ಪೂ	पुष्पसम्भवे	pū	to bloom.
ಪರೆಪು	प्रसरे	parepu	to spread (o.r. parapu).
ನೆರೆಪು, ನೆರಪು	सन्ग्रहे	nerepu, nerapu	to collect.
ತಿರುಪು	भ्रमणे	tirupu	to turn round.
ಉರಿಪು, ಉರುಪು	अग्निबाधे	uripu, urupu	to cause to burn or flame.
ಮುರಿಪು	मुष्टिभ्रमणे	muripu	to whirl the fist.
ತಣಿಪು	तृप्तौ	taṇipu	to satisfy.
ಪೋಪು	आसन्नगमने	pōpu	to be zealously active in going (cf. 91).
ಮದಿಪು	मरनकरणे	madipu	to kill.
ಕೆಡಪು	पतने	keḍapu	to make fall (o.r. keḍepu, kiḍipu).
ಕೊಡಪು	करविकीर्णे	koḍapu	to scatter about with the hand.
ಸಲಪು	रक्षणे	salapu	to preserve, to protect, etc.
ಇೞಿಪು	अधःस्थाने	iḻipu	to cause to descend, to lower.
ಗೞಪು	बहुभाषणे	gaḻapu	to chatter.
ಕಳಿಪು	अनुगमने	kaḷipu	to send after.
ತಿಳಿಪು	क्र्õधोत्सर्जने	tiḷipu	to abandon one's anger.
ಅೞಿಪು	ल्õपत्वे	aḻipu	to destroy.
ಉೞಿಪು	शेषकरणे	uḻipu	to let remain.
ಅಪ್ಪು	आलिङ्गने	appu	to embrace.
ಒಪ್ಪು	सौन्दर्ये	oppu	to be beautiful.
ಸೊಪ್ಪು	निवारणे	soppu	to keep off, etc.
ತಪ್ಪು	स्खलने	tappu	to slip, to err.
ಱೆಪ್ಪು	प्रहरणे	ṟeppu	to strike.
ಕಪ್ಪು	खनने	kappu	to dig.
ಕುಪ್ಪು	पुञ्जीकरणे	kuppu	to heap together.
ಬೀ	अवसाने	bī	to end, perish.
ನಂಬು	विश्वासे	nambu	to trust.
ತುಂಬು	पूरणे	tumbu	to become full.
ತಿಂಬು	पूरणे	timbu	to fill.
ಆಂಬು	शोषणे	āmbu	to dry.
ನಾಂಬು	आलस्ये	nāmbu	to be idle.
ಅಲಂಬು	जलक्षालने	alambu	to wash with water.
ತಱುಂಬು	गतिस्तम्भे	taṟumbu	to stop.
ಕಱುಂಬು	असूये	kaṟumbu	to envy.
ಉಱುಂಬು	युद्धक्रमणगमने	uṟumbu	to march, march against.
ಅಸುಂಬು	सञ्चालने	asumbu	to shake.
ಕಲುಂಬು	कलुषीकरणे	kalumbu	to make turbid.
ನಿಗುಂಬು	पुञ्जीकरणे	nigumbu	to amass.
ನಿಲುಂಬು	पुञ्जीकरणे	nilumbu	to amass.
ತುಬ್ಬು	च्õरसूचने	tubbu	to inform against a thief; to be detected as a thief.
ಗೆರ್ಬು	मैथुने	gerbu	to have sexual intercourse.
ಪರ್ಬು	विस्तारे	parbu	to spread.
ಕೊರ್ಬು	समृद्धौ	korbu	to increase, to fatten.
ಉರ್ಬು	उत्साहॊद्वर्तनयोः	urbu	to become full of effort, etc.; to rise or swell.
ಜರ್ಬು	आक्रमणध्वनौ, आग्रहध्वनौ	jarbu	to scold, etc.
ತರ್ಬು	आश्लेषे	tarbu	to embrace.
ಎೞ್ಬು	उत्सर्पणे	eḻbu	to rise.
ಬೇ	दाहे	bē	to be burnt up.
ಬಾ	श्õभे	bā	to swell.
ಮೀ	स्नपने	mī	to bathe.
ಕೆಮ್ಮು (ಕಿಮ್ಮು)	कासे	kemmu (kimmu)	to cough.
ಕಮ್ಮು	दन्तस्वाने, गन्धश्वासे	kammu	breath to be fragrant.
ಕುಮ್ಮು	मुसलक्रियायाम्	kummu	to work with a pestle, to pound.
ಒಮ್ಮು	अनुवर्तने	ommu	to assent, etc.
ಚಿನಿಮು	युगाङ्गुलिविम्õचने	cinimu	to discharge by means of the fingers,
ಹಮ್ಮು	रज्जुक्रियायाम्	hammu	to make or twist a rope.
ನೆಮ್ಮು	पृष्टस्थापने	nemmu	to lean on, etc.
ಅಣ್ಮು	पौरुषे	aṇmu	to be strong.
ಪೊಣ್ಮು	उद्गमने	poṇmu	to rise, appear.
ಉಣ್ಮು	उद्गतौ	uṇmu	to rise.
ಕಯ್ಗಣ್ಮು	अतिक्रमणे	kaygaṇmu	to overstep.
ಕರೆಗಣ್ಮು	कूलातिक्रमणे	karegaṇmu	to over step the boundary.
ನಮೆ	गुरुयाप्ये	name	to become insignificant in bulk,
ಸಮೆ	निर्वहणे	same	to be made ready, etc.,
ಮೇ	तिर्यक्खादने	mē	to eat as beasts do, to graze.
ಪೊಯ್	ताडने	poy	to strike.
ಬಯ್	निक्षेपे	bay	(o.r. vikṣēpē) to put aside.
ಗೆಯ್	शिल्पे	gey	to perform manual or mechanical art.
ನೆಯ್	वस्त्रक्रियायाम्	ney	to weave.
ಕೊಯ್	लवने	koy	to cut, reap.
ಉಯ್	नियामे	uy	to restrain.
ಆರಯ್	अन्वेषणे	āray	to search.
ಸುಯ್	उच्сह्वासे	suy	to breathe, sigh.
ತೊಯ್, ತುಯ್	सार्द्यत्वे	toy, tuy	to become wet.
ಕಾಯ್	फलोत्पत्तौ	kāy	fruit to grow.
ಆಯ್	विरलवस्त्वाकर्षणे	āy	to pick up single things, select.
ಪಾಯ್	लङ्घने	pāy	to pass over.
ಮನಂಬೊಯ್	समग्रचेष्तायाम्	manamboy	to be replete with activity.
ಕಡುಕೆಯ್	तीव्रत्वे	kaḍukey	to basten.
ಒಲಕೆಯ್	अन्तःक्रियायआ	olakey	to do or to put inside, etc.
ತೞ್ಪೊಯ್	प्रतिहते	taḻpoy	to be obstructed, to hinder.
ಕಯ್ಗಾಯ್	सम्रक्षणे	kaygāy	to protect.
ತುೞಿಲ್ಗೆಯ್	नमस्कारे	tuḻilgey	to make obeisance.
ಕಯ್ಗೆಯ್	भूषन्õद्वहने	kaygey	to trim, to adorn.
ಎಂಬುಕೆಯ್	अनुमते	embukey	to assent.
ಇಂಬುಕೆಯ್	स्थानसङ्ग्रहे	imbukey	to seize a place.
ಅಪ್ಪುಕೆಯ್	अङ्गीकरणे	appukey	to agree, consent.
ಕಯ್ವೊಯ್	प्रतिज्नायाम्	kayvoy	to agree, assent
ಸರಿ	पलायने	sari	to go backwards, flee.
ಸುರಿ	गलने	suri	to drop.
ಬಿರಿ	स्फुटने	biri	to burst.
ಅರಿ	कृन्तने	ari	to cut, cut off.
ಕಿರಿ	वपने	kiri	to shave; tantu granthi varāhayõḥ a knot in thread; a hog.
ಮುರಿ	वक्रभावे	muri	to be bent, grow crooked.
ಹರಿ, ಪರಿ	धावने	hari, pari	to run, flow.
ಉರಿ	दहने	uri	to burn.
ಕರಿ	अतिदाने	kari	to be burnt, to cinder, be charred.
ಹುರಿ	निर्द्रवकरणे	huri	to make dry, parch.
ಜರಿ	तीरपतने	jari	to slide or slip down, as a baṅk.
ನಿಮಿರ್	प्रसारणे	nimir	to extend, become straight.
ಅಮರ್	गात्रश्लेषे	amar	to be closely united, be liṅked to.
ಬೆಮರ್	स्वेदभावे	bemar	to be in perspiration.
ತಿಮಿರ್	त्वङ्मलविसर्जने	timir	to do away with filth of excretion of the skin.
ಅಡರ್	अरोहणे	aḍar	to ascend, climb.
ತೊಡರ್	बन्धने	toḍar	to be bound.
ಬಿದುರ್	अशृङ्खलायाम्	bidur	to unite.
ಪೊಡರ್	स्फुरणे	poḍar	to tremble.
ಅದಿರ್	कम्पने	adir	to tremble.
ಬಿದಿರ್	विकीर्णे	bidir	to be scattered, spread out.
ಉದಿರ್	पतने	udir	to fall down from above.
ಅಲರ್	विकसने	alar	to open, blossom.
ಮಲರ್	पराङ्मुखे	malar	the face to be turned or averted.
ಪೋರ್	मल्लयुद्धे	pōr	to wrestle.
ಸಾರ್	समीपगमने	sār	to come or go near.
ನೇರ್	कृन्तने	nēr	to cut, cut off.
ಪಾರ್	समयान्वेषणे	pār	to search for a time or occasion, look for.
ಗೋರ್	जलकरणे	gōr	to catch with a net, fish.
ಸೇರ್	सानुमते	sēr	to agree with.
ಕೂರ್	स्नेहे	kūr	to be attached to.
ಬಾರ್	चर्मवल्लीकरणे	bār	to cut leather lengthwise or in straps; drava-dravyanirmuktau to set free a liquid, pour out.
ಸ್õರ್	गलने	sõr	to drop,
ಕಾರ್	खादने	kār	to bite.
ಹೀರ್, ಪೀರ್	रसास्वादने	hīr, pīr	to suck a liquid.
ಆರ್	उच्चैर्ध्वनौ	ār	to cry aloud; halānvita-vr̥sabha-yugmē a pair of oxen yoked to a plough,
ಕೊನರ್	पल्लव्õत्पत्तौ	konar	to sprout.
ಚಿಗುರ್	पल्लव्õत्पत्तौ	cigur	to sprout.
ತಳಿರ್	पल्लव्õत्पत्तौ	taḷir	to sprout
ಕನರ್	अपक्वरसे	kanar	the taste of something upripe to exist.
ಒಸರ್	स्रवणे	osar	to ooze.
ಕಿಸುರ್	असह्यभावे	kisur	to be of an intolerable nature or very disagreeable.
ಅಸುರ್	असह्यभावे	asur	to be of an intolerable nature or very disagreeable.
ಉಸಿರ್	भषने	usir	to speak.
ಕಸರ್	गलकण्डूतौ	kasar	to scratch the throat, to be astringent to the taste.
ಪಸುರ್	हरितभावे	pasur	to be green.
ತಗರ್	गतिबन्धने	tagar	to stop.
ಬಿಗುರ್	भये	bigur	to fear.
ಇರ್	स्थायीभावे	ir	to be, to stay.
ತರ್	आनये	tar	to bring.
ಬರ್	आगमने	bar	to come.
ಎೞ್ತರ್	समीपगमने	eḻtar	to come near.
ಎಯ್ಲರ್	समीपगमने	eylar	to come near.
ಸಾರ್ತರ್	समीपगमने	sārtar	to come near.
ಪೊರೆ	प्õषने	pore	to nourish.
ನೆರೆ	सम्योगे	nere	to be united.
ಅರೆ	पेषणे	are	to grind.
ಒರೆ	कर्षणे	ore	to draw.
ಕರೆ	आह्वाने	kare	to call.
ತೊರೆ	स्तन्ये	tore	milk to come to breast.
ಕೊರೆ	निद्राङ्गध्वनौ	kore	to snore.
ಎರೆ	यच्ञायाम्	ere	to beg
ಪರೆ	प्रसारने	pare	to extend.
ಬರೆ	विलेखने	bare	to write.
ಮುರೆ, ಮೊರೆ	भ्रमरादिनिनादे	mure, more	to sound as a black bee and other insects
ಕೆರೆ	नखक्रियायाम्	kere	to scratch with the nails.
ಮಿಳಿರ್	लुठने	miḷir	to move about.
ತಳರ್	चलने	taḷar	to move.
ಅಳುರ್	आवरणे	aḷur	to cover.
ತಳಿರ್	पल्लव्õत्पत्तौ	taḷir	to sprout.
ಕಿಳಿರ್	हयध्वनौ	kiḷir	to neigh.
ಬೆಳರ್	धावल्ये	beḷar	to become white or bright.
ಕೆಳರ್	विजृम्भणे	keḷar	to expand, yawn.
ಮಿಳಿರ್	समृद्धौ	miḷir	to increase.
ಕುಳಿರ್	ऋजुभेदे	kuḷir	to bend, sit down.
ಮಲೆ	औद्धत्ये	male	to be puffed up.
ಕೆಲೆ	उत्सहध्वनौ	kele	to shout with energy or for joy.
ಒಲೆ	ओन्दोलने	ole	to be in a swinging motion.
ಅಲೆ	परिभाव-ल्õलनयोः	ale	to slight, disgrace, to shake, be unsteady.
ಅಂಡಲೆ	आसन्नपीडने	aṇḍale	to oppress, harass.
ಕಣ್ಮಲೆ	चित्तस्फुरणे	kaṇmale	to flash on the mind.
ಪೊಲ್	स्यूते	pol	to sew.
ಕಿಚಿಕಿಲ್	हेषिते	kicikil	to neigh.
ಕುಕಿಲ್	कोकिलस्वने	kukil	to sound as a cuckoo.
ಒಱಲ್	स्नेहे	oṟal	to love.
ನೆಱಲ್	निश्चेष्टावलम्बने	neṟal	to hang down motionless or powerless; to faint.
ಕೞಲ್	तनुत्वे	kaḻal	to be thin; takra-mañjīrayōḥ butter milk mixed with water; a foot-ring, aṅklet.
ಅವಲ್	मुसलक्रियायाम्	aval	to work with the pestle, to pound,
ಬೞಲ್	श्रान्तौ	baḻal	to be weary.
ತೊೞಲ್	भ्रमणे	toḻal	to whirl round; to wander about.
ಅೞಲ್	दुह्खे	aḻal	to sorrow, to grieve.
ಎೞಲ್	आलम्बने	eḻal	to hang down, be pendent.
ಪಿಳಿಲ್	हस्तोन्मुक्तौ	piḷil	to let loose from the hand.
ಮರಲ್	पराङ्मुखे	maral	the face to be turned or averted; to turn backwards.
ಅರಲ್	विकासे	aral	to open, blow.
ಕನಲ್	क्र्õधे	kanal	to be angry.
ಒನಲ್	अपहसनक्रोधे	onal	to be in scornful wrath, in wrath which knows no smile.
ನರಲ್	वेदनध्वनौ	naral	to groan, moan.
ಮಡಲ್	वल्लिवृद्धौ	maḍal	to spread out or run as a creeper.
ಸಿಡಿಲ್	विकीर्णे	siḍil	to be scattered .
ತಳಲ್	शाखामुखे	taḷal	to bud, shoot as branches.
ಎಲೆ	तळल्-पल्लवप्राप्तौ	ele	to get sprouts or shoots.
ಜೋಲ್	आलम्बने	jōl	to hang down, be suspended.
ಕೊಲ್	हिम्सायाम्	kol	to kill.
ಸಲ್	स्थानप्रवेšए	sal	to enter a place, to enter.
ನಿಲ್	गतिमुक्तौ	nil	to cease from walking, stand.
ಬಿಲ್	विक्रये	bil	to sell.
ಕಲ್	अभ्यासे	kal	to learn.
ಜಿಗಿಲ್	स्निग्धसङ्क्लेषयोः	jigil	to be sticky, gummy; to suffer distress.
ಪಗಿಲ್	स्निग्धसङ्क्लेषयोः	pagil	to be sticky, gummy; to suffer distress.
ತಱಿಸಲ್	निश्चये	taṟisal	to be ascertained, settled.
*ಬೞಿಸಲ್	अनुगमने	*baḻisal	to follow.
ಸ್õಲ್	पराजये	sõl	to lose, be defeated.
ಸಾಲ್	ऋणे	sāl	to get into debt.
ಪೋಲ್	सादृश्ये	pōl	to resemble.
ನೂಲ್	तन्तुकरणे	nūl	to make thread.
ನೇಲ್	आलम्बने	nēl	to be suspended, to hang.
ಪೇಲ್	मलविसर्जने	pēl	to void excrement:
ಅವಿ	निगूहने	avi	(o.r. gūhanē) to cover, hide.
ಕವಿ	अच्छदने	kavi	to cover.
ಸವಿ	खादनपर्क्षायाम्	savi	to test by eating, to taste.
ತಿವಿ	मुष्टिप्रहरणे	tivi	to strike with the fist.
ತವು	क्षये	tavu	to decrease, to waste away.
ಒದವು	सम्द्धौ	odavu	to thrive.
õವು	पालने	õvu	to guard, protect.
ಸಿವು	भूषणे	sivu	to adorn.
ತೀವು	प्üरणे	tīvu	to fill; to become full.
ಎೞವು	अपमर्जने	eḻavu	to remove by wiping or rubbing.
ಗರವು	सर्वकर्षणे	garavu	to draw the whole towards one’s self.
ತಡವು	हस्तान्वेषणे	taḍavu	to seek with the hands, grope.
ಅೞ್ವು	दहनातिक्रमणे	aḻvu	burning to go beyond the proper limit.
ತಳ್ವು	कालाक्षेपे	taḷvu	to delay.
ಎಳವು	विधिकरणे	eḷavu	to order, to arrange.
ಹುಸಿ	अनृते	husi	to be false, to lie.
ನಸಿ	जीर्णे	nasi	to decay.
ಬಸಿ	गलने	basi	to drip.
ಕುಸಿ	क्षीणत्वे	kusi	to sink, give way.
ಹಸಿ	क्षुधायाम्	hasi	to hunger.
ಕಿಸಿ	विकसने	kisi	to open.
ಸಸಿ	सस्याद्युत्पाटने	sasi	to pull out as corn.
ಬೀಸು	आवर्तने	bīsu	to turn round.
ಪಾಸು	आस्तरणक्रियायाम्	pāsu	to lay, spread out.
ಸೂಸು	परित्यागे	sūsu	to quit, let go.
ಅಸು	ऊर्ध्वविमोचने	asu	to release from above.
ಮಾಸು	मलीमसे	māsu	to become dirty.
ಹೇಸು	जुगुप्सायाम्	hēsu	to feel aversion.
ಬಾಸು	पुरीष्õत्सर्गे	bāsu	to void excrement.
ಕೀಸು	क्शिकरणे	kīsu	to make thin.
ಮೂಸು	आघ्राणे	mūsu	to smell.
ಪೂಸು	विलेपने	pūsu	to besmear, plaster.
ಈಸು	जल्õत्तरणे	īsu	to cross water in swimming.
ಹೂಸು	अधोवायौ	hūsu	to break wind downwards, fart.
ಕಾಸು	दाहे	kāsu	to make hot, to heat.
ಕೋಸು	सूत्रप्रवेशे	kōsu	to cause to thread.
ಕಯ್ವಿಸು	रणारम्ब-हस्तसूचनयोः	kayvisu	to begin fighting by flourishing the hands; to give a sign with the hand.
ಅಱಸು	अन्वेषणे	aṟasu	to search.
ಮಱಸು	आच्छादने	maṟasu	to conceal, hide.
ತುಱಿಸು	कण्डूतिकर्षणे	tuṟisu	to scratch what itches.
ಮೊಗಸು	उद्योगारम्भे	mogasu	to begin, to exert one's self.
ಉೞಿಸು	सहने	uḻisu	to bear, endure.
ಎಳಸು	इच्छायाम्	eḷasu	to desire.
ಬಳಸು	भ्रमण-कञ्चुकाङ्गयोः	baḷasu	to go round; a coat of mail.
ಬೆರಸು, ಕಲಸು	सम्मिश्रे	berasu, kalasu	to mix or be mixed.
ಅಡಸು	गाधप्रवेशे	aḍasu	to enter closely or firmly.
ಅಲಸು	आलस्ये	alasu	to become tired or fatigued.
ಸೆಣಸು	ईर्षायाम्	seṇasu	to envy.
ಒರಸು	घर्षने	orasu	to rub.
ಇಸು	शरविमोचने	isu	to shoot, as an arrow.
ಬಿಸು	ल्õहसन्धाने	bisu	to put metals together, solder.
ಪಸು	विभजने	pasu	to divide.
ಕೊಸೆ	निधुवनकरणे	kose	to have sexual intercourse.
ಪೊಸೆ	रज्जुक्रियायाम्	pose	to make rope, twist.
ಬೆಸೆ	गर्वे	bese	to be proud.
ನೆಸೆ	उत्पवने	nese	to be purified.
ಮಸೆ	घर्षणे	mase	to rub, wheat.
ಎಸೆ	श्õभायाम्	ese	to shine.
ಒಸೆ	प्रसन्ने	ose	to be delighted.
ಚಿತ್ರಿಸು	रूपादिलेखने	citrisu	to draw a picture.
ಸೂತ್ರಿಸು	मानसूत्रस्थापने	sūtrisu	to place a measuring line.
ಗರ್ಜಿಸು	भयङ्करध्वनौ	garjisu	to roar.
ತರ್ಜಿಸು	निवारणे	tarjisu	to keep off.
ಮುದ್ರಿಸು	अङ्गीकरणे	mudrisu	to agree to, to assent.
ಭದ್ರಿಸು	मुण्डनक्रियायाम्	bhadrisu	to shave.
ವರ್ಣಿಸು	स्तोत्रे	varṇisu	to praise.
ಘೂರ್ಣಿಸು	विजृम्भणे	ghūrṇisu	to gape, expand.
ಶಿಕ್ಷಿಸು	नियमे	śikṣisu	to restrain, subdue.
ವಾಳಿಸು, ಮೇಳಿಸು	संयोगे	vāḷisu, mēḷisu	to be joined.
ರಕ್ಷಿಸು	पालने	rakṣisu	to protect.
ರಾಜಿಸು	श्õभायाम्	rājisu	to shine.
ಪೂಜಿಸು	अर्चनविधौ	pūjisu	to worship, adore.
ವರ್ತಿಸು	वर्तने	vartisu	to be occupied.
ಕೀರ್ತಿಸು	वर्णने	kīrtisu	to praise.
ನೀರಾಜಿಸು	आरतीकक्रियायाम्	nīrājisu	to wave lamps before a person or idol.
ಯೋಜಿಸು	अनुमते	yōjisu	to assent to.
ಜೇಂಕರಿಸು	प्रशंसायाम्	jēṅkarisu	to praise.
ಮಾಂಕರಿಸು, ಮಾಕರಿಸು	अवज्ञायाम्	māṅkarisu, mākarisu	to surpass.
ಶಾಸಿಸು	शिक्षायाम्	śāsisu	to teach, train.
ವಾಸಿಸು	आघ्राणे	vāsisu	to smell.
ನಿಯಾಮಿಸು	आज्ञापने	niyāmisu	to command.
ಅಭಿನಯಿಸು	अनुकरणे	abhinayisu	to imitate, represent.
ರಂಜಿಸು	श्õभायाम्	rañjisu	to shine.
ಪುಂಜಿಸು	राशौ	puñjisu	to heap.
ರಂಜಿಸು	रागे	rañjisu	to paint.
ಭಂಜಿಸು	अपमाने	bhañjisu	to dishonour.
ಉದಾಹರಿಸು	कथने	udāharisu	to relate.
ಚರಯಿಸು, ಚರಿಯಿಸು	भ्रमणे	carayisu, cariyisu	to walk about.
ವರಯಿಸು, ವರಿಯಿಸು	स्वीकारे	varayisu, variyisu	to adopt, make one's own.
ಕೋಪಿಸು	अमर्षे	kōpisu	to become angry.
ಸ್ಥಾಪಿಸು	न्यासकरणे	sthāpisu	to put down, place.
ಸಂಚಿಸು	सङ्ग्रहे	sañcisu	to collect.
ವಂಚಿಸು	अपलापे	vañcisu	to conceal, deny.
ರಮಿಸು	क्रीडायाम्	ramisu	to enjoy carnally.
ಗಮಿಸು	गमकृते	gamisu	(o.r. gamakatvē) to go.
ಆಲಿಸು	आकर्णने	ālisu	to listen attentively.
ಮಾಲಿಸು	कटाक्षे	mālisu	to cast a side-glance.
ನಿಗುಂಬಿಸು	सङ्कीर्णराशौ	nigumbisu	a heap to be formed of miscellaneous things.
ನಂಬಿಸು	अनुम्õदने	nambisu	to cause, to assent.
ಗುಡಿಯಿಸು, ಗುಡಿಸು	पुञ्जीकरणे	guḍiyisu, guḍisu	to make a heap.
ಬಡಿಸು	ओल्गक्रियायाम्	baḍisu	(vālagakriyāyām) to serve up or cut.
ನಿಟ್ಟಿಸು	निर्भरालोके	niṭṭisu	to look excessively.
ತುಟ್ಟಿಸು	शक्तिक्षये	tuṭṭisu	strength to be diminished.
ಓಸರಿಸು	अपादाने	ōsarisu	to remove.
ಬೋಸರಿಸು	मिथ्यादरे	bōsarisu	to flatter.
ಮುಕ್ಕುಳಿಸು	गण्डूषे	mukkuḷisu	to rinse the mouth with water.
ಬಿಕ್ಕುಳಿಸು	उद्गारे	bikkuḷisu	to vomit.
ಅಕ್ಕುಳಿಸು	निम्नकुक्षौ	akkuḷisu	to contract the body,
ನಿಕ್ಕುಳಿಸು	विलासावनम्रे	nikkuḷisu	to bend one's self from couquetry.
ಜಕ್ಕುಳಿಸು	नर्मकरणे	jakkuḷisu	to jest at.
ಕುಪ್ಪಳಿಸು	राशौ	kuppaḷisu	to heap.
ಅಪ್ಪಳಿಸು	आस्फालने	appaḷisu	to flap.
ಬಿತ್ತರಿಸು	विस्तारे	bittarisu	to spread.
ಒತ್ತರಿಸು	उद्वृत्तायाम्	ottarisu	to act haughtily (o.r. udvrittau).
ಉಮ್ಮಳಿಸು	चिन्तायाम्	ummaḷisu	to grieve.
ದೊಮ್ಮಳಿಸು	तिर्यक्समूहसम्भ्रमे	dommaḷisu	to be agitated or alarmed, as a herd of cattle.
ಕೊಕ್ಕರಿಸು	विभत्सर्जने	kokkarisu	(o.r. nirbhartsanē) to threaten.
ಚೆಕ್ಕರಿಸು, ಬೆಕ್ಕರಿಸು	अजध्वनौ	cekkarisu, bekkarisu	to bleat.
ಆಲಿಸು	परिभावने	ālisu	to thiṅk about.
ಸ್õಲಿಸು	अपजये	sõlisu	to defeat.
ಸಂದಣಿಸು	समूहे तॊ च्रॊwद्।	sandaṇisu	bāhulyē ca
ಗೊಂದಣಿಸು	समूहे तॊ च्रॊwद्।	gondaṇisu	bāhulyē ca
ಬಿಚ್ಚೞಿಸು	विस्तारे	biccaḻisu	to spread out.
ಪುಚ್ಚೞಿಸು	लये	puccaḻisu	to melt away, be destroyed.
ಬೆಚ್ಚಳಿಸು	विमोहे	beccaḷisu	to become bewildered or be beguiled.
ಟೆಬ್ಬರಿಸು	कुण्ठीकरणे	ṭebbarisu	to make blunt, stupid.
ಗಬ್ಬರಿಸು	खनने	gabbarisu	to dig.
ಉಬ್ಬರಿಸು	पूरणे	ubbarisu	to swell.
ಕುರ್ಗಿಸು	सङ्कोचे	kurgisu	to cause to be bent.
ಜಾನಿಸು	ध्याने	jānisu	to meditate.
ಜಿನಿಗಿಸು	नष्तचेष्टायाम्	jinigisu	to be or make motionless.
ತಡವರಿಸು	अन्वेषणे	taḍavarisu	(o.r.s, asauṣṭanē, sauṣtanē to grope)
ಗುಡುಗುಡಿಸು, ಗುಡಿಗುಡಿಸು	कोप्õद्रेके	guḍuguḍisu, guḍiguḍisu	to be excessively angry.
ಚಿಮಿಚಿಮಿಸು	शब्दे	cimicimisu	to make a certain sound.
ಕದಕದಿಸು	सञ्चलत्वे	kadakadisu	to tremble, shake.
ಕಳವಳಿಸು	मनोवैकल्यॆ	kaḷavaḷisu	to be agitated in one's mind.
ಕನವರಿಸು	निद्राविकारे	kanavarisu	to talk in one's sleep.
ಸೈರಿಸು	सहने	sairisu	(o.r. kṣamatvē) to bear, forbear.
ಸೊಗಯಿಸು	श्õभायाम्	sogayisu	to shine.
ಮಂದಯಿಸು	सान्द्रत्वे	mandayisu	to thicken.
ಸಂದಿಸು	सन्धाने	sandisu	to unite, join.
ಚಾಳಿಸು	चापल्ये	cāḷisu	to be unsteady.
ಕಡೆಗಣಿಸು	अवज्ञायाम्	kaḍegaṇisu	to disrespect.
ಸಮನಿಸು	प्राप्तौ	samanisu	to be acquired.
ತವಿಸು	क्षये	tavisu	to cause to decrease.
ಅವಧರಿಸು, ಅವಧಾರಿಸು	स्मरणे	avadharisu, avadhārisu	to consider.
ಕಿನಿಸು	कोपे	kinisu	to be angry.
ಹನಿಸು	रसदाने	hanisu	to present a liquid.
ಬಿನ್ನವಿಸು	विज्ञापने	binnavisu	to petition.
ಪೆರ್ಚಿಸು	वर्धने	percisu	to cause to grow.
ಬೆರ್ಚಿಸು	भये	bercisu	to cause to suffer fear.
ಮಾಡಿಸು	निर्मापणे	māḍisu	to cause to perform.
ನ್õಡಿಸು	लोचनक्रियायाम्	nõḍisu	to cause to see.
ಆಡಿಸು	नर्तनविधौ	āḍisu	to cause to play.
ಪದಿಸು	गाने	padisu	to cause to sing.
õದಿಸು	शास्त्रशिक्षायाम्	õdisu	to cause to read, as the śāstras.
ಕಾದಿಸು	सङ्गरक्रियायाम्	kādisu	to cause to fight.
ಮುತ್ತಿಸು	दुर्गसम्वेष्टने	muttisu	to cause to encompass as a fort.
ಎತ್ತಿಸು	उद्धरणे	ettisu	to cause to lift up.
ತೊಡೆಯಿಸು	लेप्यकरणे	toḍeyisu	to cause to smear.
ಕಡಿಯಿಸು	खण्डने	kaḍiyisu	to cause to cut.
ಅೞಿಯಿಸು	लये	aḻiyisu	to cause to be destroyed.
ಮುಳಿಯಿಸು	कोपे	muḷiyisu	to cause to become angry.
ಕಟ್ಟಿಸು	बन्धने	kaṭṭisu	to cause to bind.
ಒಟ್ಟಿಸು	पुञ्जीकरणे	oṭṭisu	to cause to heap.
ಪೊದೆಯಿಸು	आच्छादने	podeyisu	to cause to cover.
ಪದೆಯಿಸು	ईप्सायाम्	padeyisu	to cause to desire.
ಅಗುೞಿಸು	खनने	aguḻisu	to cause to dig.
ತೆಗೞಿಸು	निन्दायाम्	tegaḻisu	to cause to blame.
ಬರೆಯಿಸು	लेखने	bareyisu	to cause to write.
ಒರೆಯಿಸು	कर्षणे	oreyisu	to cause to draw.
ಮೆಱೆ	विडम्बे	meṟe	to make manifest, to display.
ಕಱೆ	दोहने	kaṟe	to milk.
ಮಱಿ	पोतकायाम्	maṟi	the young of an animal to be born (?).
ತೆಱೆ	अनावरणोद्घटनयोः	teṟe	to be uncovered, to open.
ನೆಱೆ	समग्रत्वे	neṟe	to become entire, full grown.
ಮಱೆ	विस्मरणे	maṟe	to forget...
ತೊಱೆ	विसर्जने	toṟe	to put away.
ಅಱಿ	ज्ञाने	aṟi	to know.
ಕಚ್ಚಿಱಿ	युगलसन्धाने	kacciṟi	to join a pair.
ಬೊಬ್ಬಿಱಿ	महारवे	bobbiṟi	to give a loud sound, to bawl.
ಪಱಿ	विच्छित्तौ	paṟi	to cut, tear.
ತಱಿ	लूने	taṟi	to clip or strip off.
ಮುಱಿ	म्õटने	muṟi	to break.
ತಱಿ	छेदे	taṟi	to cut.
ನುಱಿ	सञ्चूर्णे	nuṟi	to be powdered.
ಪಱಿ	भूषने	paṟi	to decorate.
ಇಱಿ	घातने	iṟi	to strike, stab.
ಅಳ್ಳಿಱಿ	स्पन्दने	aḷḷiṟi	to tremble, shake.
ಈದಿರಿ	शृङ्गसङ्कर्षणे	īdiri	to rub with the horns.
ಪಾಂಗಱಿ	प्रकारगमने	pāṅgaṟi	to go in proper order.
ಎಡೆಗಿಱಿ	सञ्छन्दने	eḍegiṟi	to be covered.
ಏಱು	आरोहणे	ēṟu	to ascend.
ಮಿಱು	अतिक्रमणे	miṟu	to transgress.
ಕೇಱು	शूर्पकरणे	kēṟu	to winnow.
ತೂಱು	उद्धूतौ	tūṟu	to rouse up.
ದೂಱು	पैशून्ये	dūṟu	to calumniate.
ತೀಱು	कबळने	tīṟu	to take mouthfuls.
ಸಾಱು	घोषणे	sāṟu	to proclaim.
ಪಾಱು	उत्प्लवने	pāṟu	to leap up, to jump.
ತೋಱು	दर्शने	tōṟu	to appear.
ಕೀಱು	आग्रह-प्रमार्जनयोः	kīṟu	to rage; to rub off or away.
ಮಾಱು	विक्रये	māṟu	to barter, sell.
ಕಱು	वमनॆ	kaṟu	to vomit.
ನಱು	दुर्गन्धे	naṟu	to smell.
ಪೇಱು	विकीर्ये	pēṟu	to scatter.
ತಾಱು	शोषणे	tāṟu	to become dry, dry up.
ಊಱು	सत्त्वे	ūṟu	to be, exist.
ಕೆದಱು	विकीर्णे	kedaṟu	to scatter, dishevel.
ಒಱೆ	स्रवणे	oṟe	to ooze, flow.
ಬೆದಱು	व्यस्ते	bedaṟu	to be agitatéd, alarmed.
ಒದಱು	आस्फोटने	odaṟu	to make noise by slapping or clapping the arms.
ಗದಱು	गर्जने	gadaṟu	to roar.
ಸಮಱು	चारुकरणे	samaṟu	to make beautiful.
ಮುಸುಱು	सञ्छन्ने	musuṟu	to cover.
ಎಡಱು	वक्रभवे	eḍaṟu	to be crooked.
ಅಳಱು	भये	aḷaṟu	to fear.
ಪೆೞರು	भये	peḻaru	to fear.
ಒಳಱು	रवे	oḷaṟu	to sound.
ಕಿಳಿಱು	हयघोषे	kiḷiṟu	to neigh as a horse.
ಪೊಱಮಾರು	पलायने	poṟamāru	to flee.
ಪೆಱು	उपलब्धौ	peṟu	to acquire.
ತೆಪ್ಪಱು	चेतनकरणे	teppaṟu	to animate.
ತಿಱು	विनिमये	tiṟu	to barter, exchange.
ಕಿಱು	व्यवधाने	kiṟu	to come between.
ಪೊಱು	शिरोधारणे	poṟu	to bear on the head.
ಎಱೆ	द्रवद्रव्यदाने	eṟe	to pour out liquids .
ಕೊಱೆ	खण्डने	koṟe	to cut.
ಜಱೆ	अवग्रहे	jaṟe	to be impeded (cf. 888).
ಅಱೆ	स्वरूपभावे	aṟe	to lose one form.
ಕಯ್ಮಱೆ	विस्मये	kaymaṟe	to be amazed.
ತೆಗೆನೆಱೆ	आकर्णान्ते	tegeneṟe	to pull to its full extent.
ಎೞ್ಚಱು	जागरणे	eḻcaṟu	to awake.
ಬೇಸಱು	आलस्ये	bēsaṟu	to be weary or fatigued.
ಆಸಱು	आलस्ये	āsaṟu	to be weary or fatigued.
ಅಳ್ಕಱು	भये	aḷkaṟu	to fear.
ಬೆಳ್ಕಱು, ಬೆೞ್ಕಱು	भये	beḷkaṟu, beḻkaṟu	to fear.
ಅಳ್ಕಱು	प्रेम्नि	aḷkaṟu	to love.
ಎಳ್ಚಱು	निद्राभावे	eḷcaṟu	to be vigilant (cf. 875).
ಪೊಚ್ಚಱು	स्फुरणे	poccaṟu	to appear.
ಆಱು	निर्द्रवे	āṟu	to dry up, become dry,
ಸೀಱು	दुःकलहे	sīṟu	to be grieved, to grow enraged.
ಕೀರು, ಕೀಱು	भयध्वनौ	kīru, kīṟu	to cry out from fear.
ಬೀಱು	स्वेच्छप्रदाने	bīṟu	to give away according to one’s inclination.
ಗಿಱು	परिभवने	giṟu	to conceive, think.
ಜಿಱು	भये	jiṟu	to fear.
ಏಱು	समग्रत्वे	ēṟu	to be complete.
ಜಱೆ	आक्रमणालापे	jaṟe	to speak assaultingly.
ಬೆಱೆ	अहङ्कारभावे	beṟe	to be arrogant.
ಕುೞಿ	खनने	kuḻi	to dig.
ಇೞಿ	निम्नावतरणे	iḻi	to come down, to descend.
ಉೞಿ	अवसिष्टे	uḻi	to remain.
ಅೞಿ	विनाशे	aḻi	to be ruined.
ಕೞಿ	निधनातिदूरय्õः	kaḻi	to end, to die, to go or be removed very far.
ಬೞಿ	सम्मार्जनमार्गवंशेषु	baḻi	to sweep; road; race; lineage.
ಕಯ್ಗೞಿ	अतिक्रमणे	kaygaḻi	to surpass.
ಅಸಕೞಿ	अतिक्रमणे	asakaḻi	to surpass.
ಪೞಿ	निन्दायाम्	paḻi	to rebuke.
ಸುೞಿ	भ्रमणे, परिभ्रमणे	suḻi	to turn round.
ತುೞಿ	पादसङ्घट्टने	tuḻi	to trample on.
ಹಿೞಿ	निर्द्रवकरणे	hiḻi	to squeeze out; dalanarthē kuḷam but when meaning ‘to burst’ it is hiḷi, for instance hiḷḷane hiḷidudu.
ಕೞೆ	जीर्णे	kaḻe	to decay, to rot.
ಎೞೆ	आक्रम्णाकर्षणे	eḻe	to draw with power, to pull.
ಕೀೞ್	उत्पाटने	kīḻ	to pull out.
ಉೞ್	हलविलेखने	uḻ	to make furrows, to plough.
ಅೞ್	रोदने	aḻ	to weep.
ಅಗುೞ್	खनने	aguḻ	to dig.
ತೆಗೞ್	निन्दायाम्	tegaḻ	to rebuke, to blame.
ಜಗುೞ್	अपसरणे	jaguḻ	to go away.
ಪೊಗೞ್	सम्स्तवने	pogaḻ	to praise.
ನೆಗೞ್	उद्योग-ख्यातयोः	negaḻ	to engage in, to be known or famous.
ಮಗುೞ್	निवर्तने	maguḻ	to return.
ಪಡಮಗುೞ್, ಪೆಡಮ್ಮಗುೞ್	परन्मुख	paḍamaguḻ, peḍammaguḻ	to turn the face backward.
ಎೞೆ	र्õधाकर्षने	eḻe	to lay hold of and forcibly to drag.
ಆೞ್	जलनिमज्जने	āḻ	to dive into water, to sit in water; sēvakē kuḷam but when meaning ‘serve’ it is written as āḷ.
ಅಗುೞ್	जलनिमज्जने	aguḻ	to dive into water, to sit in water; sēvakē kuḷam but when meaning ‘serve’ it is written as āḷ.
ಬಾೞ್	जीवने	bāḻ	to live; khaḍgē kuḷam but when meaning ‘sword’ written as bāḷ.
ಪೋೞ್	विदारणे	pōḻ	to cleave asunder, split.
ಪೂೞ್	आच्छादने	pūḻ	to cover.
ಬೀೞ್	पतने	bīḻ	to fall.
ಏೞ್	उत्थाने	ēḻ	to rise.
ಪಾಱೇೞ್	निर्धावने	pāṟēḻ	to run away.
ಜೀಱೇೞ್	ध्वनिविकारे	jīṟēḻ	to sound strangely, to scream.
ಬೆಳೆ	सस्यव्रिद्धौ	beḷe	to grow, as corn.
ಬಳೆ	प्रवृद्धौ	baḷe	to grow up, to prosper,
ತಳೆ	धारणे	taḷe	to obtain; atapatrabhēdē ṟaḻam when meaning ‘parasol’ it is written as taḻe.
ಮೊಳೆ	प्ररोहक्रियायाम्	moḷe	to sprout; get shoots.
ಸೆಳೆ	आकर्षणे	seḷe	to draw.
ಅಳೆ	परिमाणे	aḷe	to measure.
ತೊಳೆ	प्रक्षालने तॊ रॆमॊवॆ ब्य् wअस्हिन्ग्, wअस्ह्।	toḷe	tūlāyām ca
ಪೊಳೆ	लुठने	poḷe	to roll about; nadyarthē ṟaḻam but when meaning ‘river’ written as poḻe.
ಕಳೆ	विसर्जने	kaḷe	to throw away; kaḷāyām kṣalam but when meaning‘lustre,’ the ḷ is kṣaḷa.
ತಳಿ	सेचने	taḷi	to spriṅkle.
ನಳಿ	नमने	naḷi	to bow.
ಚಳಿ	विगतप्रभावे	caḷi	(o.r. vigatabhāva) to be deprived of power.
ಮುಳಿ	कोपे	muḷi	to be angry.
ತಿಳಿ	नैर्मल्ये	tiḷi	to be or become clean or clear; jñānaprasannabhāvayōḥ to be known, to know; to be pleased.
ಕೆಳೆ	आकर्षणे	keḷe	to draw towards one's self.
ತೂಳ್	अवसर्पणे	tūḷ	to retreat.
ತಾಳ್	धारणे	tāḷ	to bear; vr̥kṣē ṟaḻam but when meaning ‘the palmyra tree’ it is written as tāḻ.
ಸೀಳ್	विदारणे	sīḷ	to cleave, split.
ಬೇಳ್	हविःप्रदाने	bēḷ	to offer into fire; nivr̥ddhau to be without growth.
ನ್õಳ್	अग्रगमने	nõḷ	to go before.
ಓಳ್	निधुवने	ōḷ	to have sexual intercourse.
ಊಳ್	दूरादाह्वाने	ūḷ	to call from afar.
ನೀಳ್	प्रसारणे	nīḷ	to extend.
ಕಳ್	स्तेये	kaḷ	to steal.
ಕೊಳ್	ग्रहणे	koḷ	to seize, take, lay hold.
ಮುಳ್	कण्टके	muḷ	to be irritated, etc.
ಮಸುಳ್	विगतप्रभायाम्	masuḷ	lustre to go away or disappear, grow dim.
ನುಗುಳ್	द्वारप्रवेशे	nuguḷ	to enter a door or opening.
ನುಸುಳ್	द्वारप्रवेशे	nusuḷ	to enter a door or opening.
ತಗುಳ್	अनुधावने	taguḷ	to run after.
ಬಗುಳ್	कुर्कुरध्वनौ	baguḷ	to sound as a dog, to bark.
ಮುಗುಳ್	निमीलने	muguḷ	to shut the eyelids.
ಸುರುಳ್	सङ्कोचने	suruḷ	to contact, shrivel, uruḷ nimnapatanē to roll down.
ಪೊರಳ್	लुठने	poraḷ	to roll.
ಸೂರುಳ್	शपथे	sūruḷ	to swear.
ಕಣ್ಗೊಳ್	दर्शनीये	kaṇgoḷ	to appear.
ಕಯ್ಕೊಳ್	स्वीकारे	kaykoḷ	to adopt.
ಬೆನ್ಗೊಳ್	अनुधावने	bengoḷ	to run after.
ದೊರೆಕೊಳ್	प्राप्तौ	dorekoḷ	to be obtained or gained.
ಮನಂಗೊಳ್	चित्तविमोहने	manaṁgoḷ	the mind to be captured.
ಅಸುಂಗೊಳ್	प्राणापहरणे	asuṁgoḷ	to take away life, to kill.
ಬೞಿಕೊಳ್	क्रमसन्धाने	baḻikoḷ	to put together in regular order.
ನೆಱೆಕೊಳ್	सर्वस्वहरणे	neṟekoḷ	to seize all
ಮಾಱ್ಕೊಳ್	सम्मुखे	māṟkoḷ	to become opposite to.
ಒಲವರಂಗೊಳ್	पक्षस्वीकारे	olavaraṁgoḷ	to side with.

